+-+-+-+-+-+-+-+-+-+-+-+-+-+-+-+-+-+-+-+-+-+-+-+-+-+-+-+-+-+-+-+-+-+-+-+
########|         |  ###|#######|#####|  #####|###|###|#####|   |   | |
+ +-+-+#+-+-+-+-+ + +#+#+#+ +-+#+#+-+#+-+#+-+#+#+#+#+#+#+-+#+ + + + + +
|     |#######|   | |#|#|#| |###|###|###|###|###|###|###|###| | | | | |
+-+-+-+-+-+-+#+ +-+-+#+#+#+ +#+-+-+#+-+#+-+#+-+-+-+-+-+-+#+-+ + +-+ + +
| |  #########| |#####|#|#| |#####|#| |###|#|   | |#######|   |     | |
+ + +#+-+-+-+-+ +#+-+-+#+#+-+-+-+#+#+ +-+#+#+-+ + +#+-+-+-+ +-+-+-+-+ +
|   |#|#####|   |###  |###|  #####|#| |###|#|   | |#######| |#####|   |
+-+-+#+#+-+#+ +-+-+#+-+-+-+ +#+-+-+#+ +#+-+#+ +-+ +-+-+-+#+ +#+-+#+ +-+
|   |###  |#|   |  ###|   | |#######| |#####|   | |   |  #| |###|#####|
+-+ +-+-+-+#+-+ + +-+#+ + + +-+-+-+-+ +-+-+-+-+ + + + +-+#+ +-+#+-+-+#+
|   |#######| | | |###| | |     |   |     |   | | | | |###| |  ###|###|
+ +-+#+-+-+-+ + +-+#+-+-+ +-+-+ + + +-+-+ + + + + + +-+#+-+ +-+-+#+#+-+
| |  #|   |   |   |#    | |     | |       | |   | |   |###  |###|#|###|
+ +-+#+-+ + +-+-+ +#+-+ + + +-+-+ +-+-+-+-+ +-+-+ +-+ +-+#+-+#+#+#+-+#+
|    #    |     | |#|     |     | |       |     | | |   |#|###|#|#|###|
+-+-+#+ +-+-+-+ + +#+-+ +-+-+-+ + + +-+-+ +-+-+ + + +-+ +#+#+-+#+#+#+-+
|   |#|           |###|     |   |   |   | |         |  ###|#|###|#|###|
+ + +#+-+-+-+-+-+-+-+#+-+-+ + +-+ +-+ + + + +-+ +-+-+ +#+-+#+#+-+#+-+#+
| |  #################|     |     |   |   |   |       |#####|#####|  ##
+-+-+-+-+-+-+-+-+-+-+-+-+-+-+-+-+-+-+-+-+-+-+-+-+-+-+-+-+-+-+-+-+-+-+-+