+-+-+-+-+-+-+-+-+-+-+-+-+-+-+-+-+-+-+-+-+-+-+-+-+-+-+-+-+-+-+-+-+-+-+-+
####|###|#####  |         |   |       |     |       |#####|#####|   | |
+ +#+#+#+#+-+#+ +-+ +-+ + +-+ + + +-+ + +-+ +-+-+-+ +#+-+#+#+-+#+ + + +
| |#|#|#|#| |#|   |   | |   |   |   |  ###|       | |###|###|###| |   |
+-+#+#+#+#+ +#+-+ +-+ +-+-+ +-+-+-+-+-+#+#+-+-+-+ + +-+#+ +-+#+ + +-+ +
|###|#|#|#  |###|   | |   | | |       |#|#######| | |###| |###| | | | |
+#+-+#+#+#+-+-+#+-+ + + +-+ + + +-+ + +#+-+-+ +#+ + +#+-+ +#+-+ + + + +
|#####|#|#|    ###| | |   | | |   | | |#|     |#|   |#|   |###| | |   |
+-+-+ +#+#+ +-+ +#+-+ +-+ + + +-+-+ +-+#+ +-+-+#+-+-+#+-+-+-+#+-+ +-+ +
| |   |###| |   |###|   |   |     | |###| |   |#|  ###|   | |###| | | |
+ + +-+-+-+ +-+-+-+#+-+ +-+-+ +-+ + +#+-+ + + +#+-+#+-+ + + +-+#+ + + +
| |   |   |       |###| | |     | | |#| | | | |#|###|   | | |###  |   |
+ + +-+ +-+-+-+ +-+-+#+ + + +-+-+ + +#+ + + +-+#+#+-+ +-+ + +#+-+-+-+-+
|   |       | | |   |#|   | |###|   |#| | |  ###|###| | | | |###|###  |
+ +-+ +-+-+ + + + + +#+-+ + +#+#+-+-+#+ + +-+#+-+-+#+ + + + +-+#+#+#+ +
|   | | |   |   | | |#|###  |#|#|###|#|   | |#####|#| | |  #####|#|#| |
+-+ + + + +-+ +-+-+ +#+#+#+-+#+#+#+#+#+ +-+ +-+-+#+#+ + +-+#+-+-+#+#+-+
|   | | |   | |     |###|#####|###|###| |   |   |###|   |###|#####|###|
+ + + + +-+ + + +-+-+-+-+-+-+-+ +-+-+ + + + + +-+-+-+-+ +#+-+#+-+-+-+#+
| |   |     |   |               |     |   | |           |#####|      ##
+-+-+-+-+-+-+-+-+-+-+-+-+-+-+-+-+-+-+-+-+-+-+-+-+-+-+-+-+-+-+-+-+-+-+-+