+-+-+-+-+-+-+-+-+-+-+-+-+-+-+-+-+-+-+-+-+-+-+-+-+-+-+-+-+-+-+-+-+-+-+-+
####|#####|   |       |#####|   |#############|#######|       |###|###|
+ +#+#+-+#+-+ + +-+-+ +#+-+#+-+ +#+-+-+-+-+ +#+#+-+-+#+ +-+-+ +#+#+#+#+
| |#|###|#####| |     |#| |###| |#|     |   |#|#    |#| |   |###|###|#|
+ +#+-+#+-+-+#+-+ +-+-+#+ +-+#+ +#+ +-+ +-+-+#+#+ + +#+ + +-+#+-+-+-+#+
| |#####|   |###|     |#| |  #####| | |     |###| | |#|   |###|   |###|
+ +-+-+-+ + +-+#+-+-+ +#+ + +-+-+-+ + +-+-+ +-+-+-+ +#+-+-+#+-+ + +#+-+
|     |   |   |#####|###|         | | |     |     | |#####|#|   | |###|
+-+-+ + +-+-+ +-+-+#+#+-+-+ +-+-+ + + + +-+-+-+-+ + +-+-+#+#+ +-+-+ +#+
|   | | |   | |  ###|###| |     |   |   |       |       |###| |     |#|
+ + + + +-+ + + +#+-+-+#+ +-+-+ +-+-+-+-+ +-+-+ +-+-+-+ +-+-+ +-+ +-+#+
| | | |     |   |#######|       |   |   |     |     |   |   | |   |###|
+ + + +-+-+-+ +-+-+-+-+-+-+-+ +-+-+ + + +-+-+ +-+-+ + +-+-+ + + +-+#+-+
| |   |   |   |         |     |   |   |   |   |   | | |   | |   | |###|
+ +-+-+ + +-+-+-+-+ +-+ + +-+-+ + +-+-+-+ + +-+ + + + + + + +-+-+ +-+#+
|     | | |         |   |   |   | |       |   | | |   | |   |   |    #|
+-+-+ + + + +-+-+-+-+ + +-+ + +-+ + +-+ +-+-+ + + +-+-+ +-+-+-+ +-+-+#+
|     | |   |   |     | |   | |   | | | |     | |     | |   |   |#####|
+ +-+-+ +-+-+ + +-+-+-+ + +-+ + +-+ + + + +-+-+ + +-+-+ + + + + +#+-+-+
|       |     |         |     |     |   |       |         |   | |######
+-+-+-+-+-+-+-+-+-+-+-+-+-+-+-+-+-+-+-+-+-+-+-+-+-+-+-+-+-+-+-+-+-+-+-+