+-+-+-+-+-+-+-+-+-+-+-+-+-+-+-+-+-+-+-+-+-+-+-+-+-+-+-+-+-+-+-+-+-+-+-+
    |   |       |         |   |       |     |       |     |     |   | |
+ + + + + +-+ + +-+ +-+ + +-+ + + +-+ + +-+ +-+-+-+ + +-+ + +-+ + + + +
| | | | | | | |   |   | |   |   |   |     |       | |   |   |   | |   |
+-+ + + + + + +-+ +-+ +-+-+ +-+-+-+-+-+ + +-+-+-+ + +-+ + +-+ + + +-+ +
|   | | |   |   |   | |   | | |       | |       | | |   | |   | | | | |
+ +-+ + + +-+-+ +-+ + + +-+ + + +-+ + + +-+-+ + + + + +-+ + +-+ + + + +
|     | | |       | | |   | | |   | | | |     | |   | |   |   | | |   |
+-+-+ + + + +-+ + +-+ +-+ + + +-+-+ +-+ + +-+-+ +-+-+ +-+-+-+ +-+ +-+ +
| |   |   | |   |   |   |   |     | |   | |   | |     |   | |   | | | |
+ + +-+-+-+ +-+-+-+ +-+ +-+-+ +-+ + + +-+ + + + +-+ +-+ + + +-+ + + + +
| |   |   |       |   | | |     | | | | | | | | |   |   | | |     |   |
+ + +-+ +-+-+-+ +-+-+ + + + +-+-+ + + + + + +-+ + +-+ +-+ + + +-+-+-+-+
|   |       | | |   | |   | |   |   | | | |     |   | | | | |   |     |
+ +-+ +-+-+ + + + + + +-+ + + + +-+-+ + + +-+ +-+-+ + + + + +-+ + + + +
|   | | |   |   | | | |     | | |   | |   | |     | | | |       | | | |
+-+ + + + +-+ +-+-+ + + + +-+ + + + + + +-+ +-+-+ + + + +-+ +-+-+ + +-+
|   | | |   | |     |   |     |   |   | |   |   |   |   |   |     |   |
+ + + + +-+ + + +-+-+-+-+-+-+-+ +-+-+ + + + + +-+-+-+-+ + +-+ +-+-+-+ +
| |   |     |   |               |     |   | |           |     |        
+-+-+-+-+-+-+-+-+-+-+-+-+-+-+-+-+-+-+-+-+-+-+-+-+-+-+-+-+-+-+-+-+-+-+-+