+-+-+-+-+-+-+-+-+-+-+-+-+-+-+-+-+-+-+-+-+-+-+-+-+-+-+-+-+-+-+-+-+-+-+-+
          |         |     |   |       |     |   |   |   |   | |       |
+ +-+-+-+ + +-+-+-+ + +-+ +-+ + +-+-+ + +-+ + + + + + + +-+ + + + +-+ +
|       | | |   | |   |   |   |   |   |   |   | | | | |     |   | |   |
+-+ +-+ + +-+ + + +-+-+-+ + +-+-+ +-+-+-+-+-+ +-+ + + +-+-+ + +-+ + +-+
| |   | |   | |   |   |   | |   |   | |   | |     |   |   | |   | |   |
+ +-+ + +-+ + +-+ + +-+ +-+ + + +-+ + + + + +-+-+ +-+-+ + + +-+-+ +-+ +
| |   |   | | |     |   |   | |   |     |   |     |     |   |   |   | |
+ + +-+-+-+ + + +-+-+ + + +-+ +-+ +-+-+-+-+ + +-+-+ + +-+-+-+ + +-+ + +
| | |       | |   | | | | |   |         |   |   |   |   |     |     | |
+ + + +-+-+ + +-+ + + + + + +-+-+ +-+-+-+ +-+-+ +-+-+-+ + +-+-+-+-+-+-+
|   |   | |   |   | | |   |   |           |   |     |   | |   |   |   |
+-+-+ + + +-+-+ +-+ + +-+-+-+ + +-+-+-+-+-+ +-+-+-+ + +-+ + + + + + + +
|   | |   |   |     |   |     |   |         |       |     | |   |   | |
+ + + +-+-+ + +-+-+ +-+ + +-+-+-+ + +-+ +-+-+ +-+-+-+ +-+-+ +-+-+-+-+ +
| |   |     |     |   | | |   |   | | |   |   |       |     |       | |
+ +-+-+-+ +-+-+-+ +-+ + + + +-+ +-+ + +-+ + +-+ +-+-+-+ +-+-+ +-+-+ + +
| | |     |     |     |   | |   |   |   |   |   |     |   | |   | |   |
+ + + +-+-+ +-+ +-+-+-+ +-+ + +-+ +-+-+ +-+-+ +-+-+-+ +-+ + +-+ + + +-+
|   |       |           |         |                       |       |    
+-+-+-+-+-+-+-+-+-+-+-+-+-+-+-+-+-+-+-+-+-+-+-+-+-+-+-+-+-+-+-+-+-+-+-+