+-+-+-+-+-+-+-+-+-+-+-+-+-+-+-+-+-+-+-+-+-+-+-+-+-+-+-+-+-+-+-+-+-+-+-+
##    |#####################|###|           |   |     |   |         | |
+#+-+ +#+ +-+-+-+-+-+ +-+ +#+#+#+ + +-+-+-+-+ + +-+-+ +-+ + +-+-+-+ + +
|###| |#| |   | |     |   |#|#|#| | |     |   | |###|###|   |###| |   |
+-+#+ +#+ + + + + +-+-+-+-+#+#+#+ + + +-+ + +-+ +#+#+#+#+-+-+#+#+ + + +
|###| |#| | |   |   | |  ###|#|#| |   | | |   | |#|#|#|#|#####|#| | | |
+#+-+-+#+ + + +-+-+ + + +#+-+#+#+-+ +-+ + + +-+ +#+#+#+#+#+-+-+#+ + + +
|#######| | |     | |   |#####|#    |     | |   |#|###|#|#    |#| | | |
+-+-+-+-+ + +-+-+-+ +-+-+-+-+-+#+-+-+ +-+-+-+ +-+#+-+-+#+#+-+-+#+ +-+ +
|   |     |             |#####|#    |       |   |###|###|#|#####|     |
+ + + +-+-+-+-+-+-+-+-+ +#+-+#+#+-+-+-+-+-+ +-+ +-+#+#+-+#+#+-+-+ +-+-+
| |   |       |     |   |#|  ###|###|   |     |   |#|#|###|#####  |   |
+ +-+-+ +-+-+ + +-+ + +-+#+-+-+-+#+#+ + +-+-+-+-+ +#+#+#+-+-+-+#+ + +-+
| |     |       |   | |###|###|###|#| |           |#|###  |###|#| |   |
+ + +-+-+-+-+-+-+ + +-+#+-+#+#+#+-+#+ +-+-+ +-+-+-+#+-+-+-+#+#+#+ +-+ +
|   |             | |###|###|###| |#|     |       |#|     |#|###| |   |
+-+-+ +-+-+-+-+-+-+ +#+-+#+-+-+-+ +#+ +-+-+ + +-+-+#+ +-+ +#+-+-+-+ +-+
|   |   |   |     | |#|###| |     |#| |###| | |#####|   | |###      | |
+ +-+ + + + + +-+ + +#+#+-+ + +-+-+#+-+#+#+-+ +#+-+-+-+ +-+-+#+-+-+-+ +
|     |   |   |   | |###    |      #####|#######|            ##########
+-+-+-+-+-+-+-+-+-+-+-+-+-+-+-+-+-+-+-+-+-+-+-+-+-+-+-+-+-+-+-+-+-+-+-+