+-+-+-+-+-+-+-+-+-+-+-+-+-+-+-+-+-+-+-+-+-+-+-+-+-+-+-+-+-+-+-+-+-+-+-+
      |                     |   |           |   |     |   |         | |
+ +-+ + + +-+-+-+-+-+ +-+ + + + + + +-+-+-+-+ + +-+-+ +-+ + +-+-+-+ + +
|   | | | |   | |     |   | | | | | |     |   | |   |   |   |   | |   |
+-+ + + + + + + + +-+-+-+-+ + + + + + +-+ + +-+ + + + + +-+-+ + + + + +
|   | | | | |   |   | |     | | | |   | | |   | | | | | |     | | | | |
+ +-+-+ + + + +-+-+ + + + +-+ + +-+ +-+ + + +-+ + + + + + +-+-+ + + + +
|       | | |     | |   |     |     |     | |   | |   | |     | | | | |
+-+-+-+-+ + +-+-+-+ +-+-+-+-+-+ +-+-+ +-+-+-+ +-+ +-+-+ + +-+-+ + +-+ +
|   |     |             |     |     |       |   |   |   | |     |     |
+ + + +-+-+-+-+-+-+-+-+ + +-+ + +-+-+-+-+-+ +-+ +-+ + +-+ + +-+-+ +-+-+
| |   |       |     |   | |     |   |   |     |   | | |   |       |   |
+ +-+-+ +-+-+ + +-+ + +-+ +-+-+-+ + + + +-+-+-+-+ + + + +-+-+-+ + + +-+
| |     |       |   | |   |   |   | | |           | |     |   | | |   |
+ + +-+-+-+-+-+-+ + +-+ +-+ + + +-+ + +-+-+ +-+-+-+ +-+-+-+ + + + +-+ +
|   |             | |   |   |   | | |     |       | |     | |   | |   |
+-+-+ +-+-+-+-+-+-+ + +-+ +-+-+-+ + + +-+-+ + +-+-+ + +-+ + +-+-+-+ +-+
|   |   |   |     | | |   | |     | | |   | | |     |   | |         | |
+ +-+ + + + + +-+ + + + +-+ + +-+-+ +-+ + +-+ + +-+-+-+ +-+-+ +-+-+-+ +
|     |   |   |   | |       |           |       |                      
+-+-+-+-+-+-+-+-+-+-+-+-+-+-+-+-+-+-+-+-+-+-+-+-+-+-+-+-+-+-+-+-+-+-+-+