+-+-+-+-+-+-+-+-+-+-+-+-+-+-+-+-+-+-+-+-+-+-+-+-+-+-+-+-+-+-+-+-+-+-+-+
        |         |     |       |     |       |   |   |     |   |   | |
+ +-+-+ +-+-+-+-+ + + + + + +-+ + +-+ +-+ +-+ + + + + + +-+ + + + + + +
|     |       |   | | | | | |   |   |   |   |   |   |   |   | | | | | |
+-+-+-+-+-+-+ + +-+-+ + + + + +-+-+ +-+ +-+ +-+-+-+-+-+-+ +-+ + +-+ + +
| |           | |     | | | |     | | |   | |   | |       |   |     | |
+ + + +-+-+-+-+ + +-+-+ + +-+-+-+ + + +-+ + +-+ + + +-+-+-+ +-+-+-+-+ +
|   | |     |   |     |   |       | | |   | |   | |       | |     |   |
+-+-+ + +-+ + +-+-+ +-+-+-+ + +-+-+ + + +-+ + +-+ +-+-+-+ + + +-+ + +-+
|   |     | |   |     |   | |       | |     |   | |   |   | |   |     |
+-+ +-+-+-+ +-+ + +-+ + + + +-+-+-+-+ +-+-+-+-+ + + + +-+ + +-+ +-+-+ +
|   |       | | | |   | | |     |   |     |   | | | | |   | |     |   |
+ +-+ +-+-+-+ + +-+ +-+-+ +-+-+ + + +-+-+ + + + + + +-+ +-+ +-+-+ + +-+
| |   |   |   |   |     | |     | |       | |   | |   |     |   | |   |
+ +-+ +-+ + +-+-+ + +-+ + + +-+-+ +-+-+-+-+ +-+-+ +-+ +-+ +-+ + + +-+ +
|         |     | | |     |     | |       |     | | |   | |   | | |   |
+-+-+ + +-+-+-+ + + +-+ +-+-+-+ + + +-+-+ +-+-+ + + +-+ + + +-+ + + +-+
|   | |           |   |     |   |   |   | |         |     | |   | |   |
+ + + +-+-+-+-+-+-+-+ +-+-+ + +-+ +-+ + + + +-+ +-+-+ + +-+ + +-+ +-+ +
| |                   |     |     |   |   |   |       |     |     |    
+-+-+-+-+-+-+-+-+-+-+-+-+-+-+-+-+-+-+-+-+-+-+-+-+-+-+-+-+-+-+-+-+-+-+-+