+-+-+-+-+-+-+-+-+-+-+-+-+-+-+-+-+-+-+-+-+-+-+-+-+-+-+-+-+-+-+-+-+-+-+-+
##########|         |     |   |       |     |   |###|###|   | |       |
+ +-+-+-+#+ +-+-+-+ + +-+ +-+ + +-+-+ + +-+ + + +#+#+#+#+-+ + + + +-+ +
|       |#| |###| |   |   |   |   |   |   |   | |#|#|#|#####|   | |   |
+-+ +-+ +#+-+#+#+ +-+-+-+ + +-+-+ +-+-+-+-+-+ +-+#+#+#+-+-+#+ +-+ + +-+
| |   | |###|#|###|   |   | |###|   | |   | |    #|###|###|#|   | |   |
+ +-+ + +-+#+#+-+#+ +-+ +-+ +#+#+-+ + + + + +-+-+#+-+-+#+#+#+-+-+ +-+ +
| |   |   |#|#|###  |   |   |#|###|     |   |#####|  ###|###|   |   | |
+ + +-+-+-+#+#+#+-+-+ + + +-+#+-+#+-+-+-+-+ +#+-+-+ +#+-+-+-+ + +-+ + +
| | |      #|#|###| | | | |###|  #      |   |###|   |###|     |     | |
+ + + +-+-+#+#+-+#+ + + + +#+-+-+#+-+-+-+ +-+-+#+-+-+-+#+ +-+-+-+-+-+-+
|   |   | |###|###| | |   |###|###        |   |#####|###| |###|###|###|
+-+-+ + + +-+-+#+-+ + +-+-+-+#+#+-+-+-+-+-+ +-+-+-+#+#+-+ +#+#+#+#+#+#+
|   | |   |###|#####|   |#####|###|#####    |#######|#    |#|###|###|#|
+ + + +-+-+#+#+-+-+#+-+ +#+-+-+-+#+#+-+#+-+-+#+-+-+-+#+-+-+#+-+-+-+-+#+
| |   |  ###|#####|###| |#|   |###|#| |###|###|#######|#####|       |#|
+ +-+-+-+#+-+-+-+#+-+#+ +#+ +-+#+-+#+ +-+#+#+-+#+-+-+-+#+-+-+ +-+-+ +#+
| | |#####|#####|#####|###| |###|###|   |###|###|     |###| |   | |###|
+ + +#+-+-+#+-+#+-+-+-+#+-+ +#+-+#+-+-+ +-+-+#+-+-+-+ +-+#+ +-+ + +#+-+
|   |#######|  #########|    #####|          #############|       |####
+-+-+-+-+-+-+-+-+-+-+-+-+-+-+-+-+-+-+-+-+-+-+-+-+-+-+-+-+-+-+-+-+-+-+-+