+-+-+-+-+-+-+-+-+-+-+-+-+-+-+-+-+-+-+-+-+-+-+-+-+-+-+-+-+-+-+-+-+-+-+-+
    |     |   |       |     |   |             |       |       |   |   |
+ + + +-+ +-+ + +-+-+ + +-+ +-+ + +-+-+-+-+ + + +-+-+ + +-+-+ + + + + +
| | |   |     | |     | | |   | | |     |   | |     | | |   |   |   | |
+ + +-+ +-+-+ +-+ +-+-+ + +-+ + + + +-+ +-+-+ + + + + + + +-+ +-+-+-+ +
| |     |   |   |     | | |       | | |     |   | | | |   |   |   |   |
+ +-+-+-+ + +-+ +-+-+ + + + +-+-+-+ + +-+-+ +-+-+-+ + +-+-+ +-+ + + +-+
|     |   |   |     |   |         | | |     |     | |     | |   | |   |
+-+-+ + +-+-+ +-+-+ + +-+-+ +-+-+ + + + +-+-+-+-+ + +-+-+ + + +-+-+ + +
|   | | |   | |     |   | |     |   |   |       |       |   | |     | |
+ + + + +-+ + + + +-+-+ + +-+-+ +-+-+-+-+ +-+-+ +-+-+-+ +-+-+ +-+ +-+ +
| | | |     |   |       |       |   |   |     |     |   |   | |   |   |
+ + + +-+-+-+ +-+-+-+-+-+-+-+ +-+-+ + + +-+-+ +-+-+ + +-+-+ + + +-+ +-+
| |   |   |   |         |     |   |   |   |   |   | | |   | |   | |   |
+ +-+-+ + +-+-+-+-+ +-+ + +-+-+ + +-+-+-+ + +-+ + + + + + + +-+-+ +-+ +
|     | | |         |   |   |   | |       |   | | |   | |   |   |     |
+-+-+ + + + +-+-+-+-+ + +-+ + +-+ + +-+ +-+-+ + + +-+-+ +-+-+-+ +-+-+ +
|     | |   |   |     | |   | |   | | | |     | |     | |   |   |     |
+ +-+-+ +-+-+ + +-+-+-+ + +-+ + +-+ + + + +-+-+ + +-+-+ + + + + + +-+-+
|       |     |         |     |     |   |       |         |   | |      
+-+-+-+-+-+-+-+-+-+-+-+-+-+-+-+-+-+-+-+-+-+-+-+-+-+-+-+-+-+-+-+-+-+-+-+